SO ./textures/purplestone.xpm
NO ./textures/red.xpm
WE ./textures/greystone.xpm
EA ./textures/eagle.xpm

C 6,5,5
F 59,5,90

11111111
10000N01
11111111

11111111
10000001
11111111
