
WE textures/profyum.xpm


NO textures/kaynito.xpm


SO textures/yummi_edg.xpm


EA textures/yumyum.xpm









F 27,100,0
C 27,30,0		





1111111111111111111111111111111111111
1100000   00100000000001 100000000001
11111111111100000000000010000001111111        1
10010000N00000000000000000000000001111111111111111111111111111111
11111111101100000111000000  00000000001
100000000000000011101111111111100001111
111101111111110111000001000100000001      
1000000000000000110101001000100011111
11111111 1110101 10111101000101111111
1111111111111111111111111111111