SO ./textures/purplestone.xpm
NO ./textures/red.xpm
WE ./textures/greystone.xpm
EA ./textures/eagle.xpm

F 59,5,90
C 6,5,5

111111111111111111111111 111111111111
 10000000000100000000001 100000000111
1111111111110000000000001000000000001
1001000000000000000000000000000000001
1111111110110000011100000000000000001
1000000000110000011101111111111100001
1111011111111101110000001000100000001
111101111111110111010100100010000001
11000000110101011100000010001000001
1000020000000000110000000000100001
100000000000000011010100100010001
11000001110101011111011110N01001
11110111 1110101 10111101000101
111111111111111111111111111111