SO ./textures/purplestone.xpm
NO ./textures/red.xpm
WE ./textures/greystone.xpm
EA ./textures/eagle.xpm

F 59,5,90
C 6,5,5

111111111111111111111111111111111111
1100000000001000000000011100000000111
1111111111110000000000001000000000001
10010000000000000000000000000000000011
11111111101100000111000000000000000001
10000000001100000111011111111111000011
1111011111111101111100001000100000001111
11110111111111010001101001001000100000011
1100000011010101111100000000000000011111
1000000000000011000000111111110001111
1000000000Q00000011010000001000111
11000001110101011111011111N010011
11110111111101011101111010011111
1111111111111111111111111111111