SO ./textures/purplestone.xpm
NO ./textures/red.xpm
WE ./textures/greystone.xpm
EA ./textures/eagle.xpm

F 59,5,90
C 6,5,5

111111111111111111111111 111111111111
 100000000001000000000011100000000111
1111111111110000000000001000000000001
1001000000000000000000000000000000001
1111111110110000011100000000000000001
1000000000110000011101111111111100001
111101111111110111110000100010000000111
1111011111111101 0 110101001000100000011
110000001101010111110000                               011111
1000000000000011000000011111110001111
100000000000000011010100100010001
11000001110101011111011110N010011
11110111 1110101 101111010001011
1111111111111111111111111111111