SO ./textures/purplestone.xpm
NO ./textures/red.xpm
WE ./textures/greystone.xpm
EA ./textures/eagle.xpm

C 6,5,5



F 59,5,90












1111111111111111111111111111111111111
1100000   00100000000001 100000000001
11111111111100000000000010000001111111        1
10010000N00000W00000000000000000001111111111111111111111111111111
11111111101100000111000000  00000000001
100000000000000011101111111111100001111
111101111111110111000001000100000001      
1000000000000000110101S01000100011111
11111111 1110101 10111101000101111111
1111111111111111111111111111111