SO ./textures/purplestone.xpm

NO ./textures/red.xpm



WE ./textures/greystone.xpm
EA ./textures/eagle.xpm

C 6,			5,5

F 59,5,									90

111111
100101
101001
1100N1
111111